###########################################################
#                                                         #
#                                          F              #
#                                                         #
#                     #####################################
#                      ####################################  
#          ########                                       #
#                                                         #
#########                                                 #
#                                                         #
#     ########                                            #
#                                                         #
#            ########                                     #
#                                                         #
#                        ########                         #
#                                                         #
#             ########                                    #
#                                                         #
#                       ########                          #
#                                                         #
#                                   ########              #
#                                                         #
#                                               ########  #
#                                                         #
#                                    ########             #
#                                                         #
#                          ########                       #
#                                                         #
#          P    ########                                  #
#                                                         #
###########################################################